8x22
**********************
*  R                 *
*         *      R   *
*  *                 *
*         H       *  *
*            **      *
*   R              R *
**********************