7x14
**************
*   R        *  
*        *   *
*           R*
*    H   *   *
*  *     R   *
**************